#####################################
#                                   #
#                                   #
#                                   #
#            ####                   #
#                                   #
#   ####                            #
#                                   #
#             ####                # #
#                                   #
#     ####                          #
#                                 ###
#                ###                #
#                                   #
#                          ####     #
#                                   #
#        ####                       #
#                         ####      #
#          @                        #
#####################################