#####################################
#                                   #
#                                   #
#                                   #
#                                   #
#                                   #
#               @                   #
#                                   #
#                                   #
#                                   #
#                                   #
#####################################
