#####################################
#                                   #
#                                   #
#                                   #
#            ####                   #
#                                   #
#   ####                            #
#                                   #
#             ####                # #
#                                   #
#     ####                          #
#                                 ###
#                ###                #
#                                   #
#                          ####     #
#                                   #
#        ----                       ###################
#        ++++             ####                        #
#          @                                          #
#####################################-----------------#
#####################################+++++++++++++++++
#####################################+++++++++++++++++
#####################################+++++++++++++++++
#####################################+++++++++++++++++
#####################################+++++++++++++++++
#####################################+++++++++++++++++
#####################################+++++++++++++++++
#####################################+++++++++++++++++
#####################################+++++++++++++++++