#####################################
#                                   #
#                                   #
#                                   #
#                                   #
#                                   #
#               @                   #
#                                   #
#                                   #
# L                                 #
# L                               U #
#####################################
