#####################################
#                                   #
#                                   #
#                                   #
#            ####                   #
#                                   #
#   ####                            #
#                                   #
#             ####                # #
#                                   #
#     ####                          #
#                                 ###
#        SS      ###               S#
#                                   #
#                              #### #
#        ----                       #
#        ++++          S            ###################
#                         ####                        #
#          @                                          #
#####################################-----------------#
#####################################+++++++++++++++++
#####################################+++++++++++++++++
#####################################+++++++++++++++++
#####################################+++++++++++++++++
#####################################+++++++++++++++++
#####################################+++++++++++++++++
#####################################+++++++++++++++++
#####################################+++++++++++++++++
#####################################+++++++++++++++++