#####################################
#                                   #
#                                   #
#                                   #
#            ####                   #
#                                   #
#   ####                            #
#                                   #
#             ####                ###
#                                   #
#     ####                          #                                                         +
#                                 ###                                                         +
#        SS      ###               S#                                                         +
#                                   #                        +++                              +
#                              #### #                                         +++             +
#        ####                                                         +++                     +
#                      S                                                                      +
#                         ####                                                                +
#          @                                                                                  +
#####################################---------------------------------------------------------+
#####################################++++++++++++++++++++++++++++++++++++++++++++++++++++++++++
#####################################++++++++++++++++++++++++++++++++++++++++++++++++++++++++++
#####################################++++++++++++++++++++++++++++++++++++++++++++++++++++++++++
#####################################++++++++++++++++++++++++++++++++++++++++++++++++++++++++++
#####################################++++++++++++++++++++++++++++++++++++++++++++++++++++++++++
#####################################++++++++++++++++++++++++++++++++++++++++++++++++++++++++++
#####################################++++++++++++++++++++++++++++++++++++++++++++++++++++++++++
#####################################++++++++++++++++++++++++++++++++++++++++++++++++++++++++++
#####################################++++++++++++++++++++++++++++++++++++++++++++++++++++++++++