#########################
#                       #
#                       #
#                       #
#            ####       #
#                       #
#   ####                #
#                       #
#             ####      #
#                       #
#     ####              #
#                       #
#                ###    #
#                       #
#                       #
#             ###       #
#                       #
#   ###                 #
#          @            #
##########################