#####################################
#                                   #
#                                   #
# Q                                 #
#--                                 #
#                                   #
#               @                   #
#                                   #
#    ---                            #
#  L +++                            #
#  L    CC                       UU #
#####################################
